,index,Rk,Player,Squad,90s,Tkl,TklW,Def 3rd,Mid 3rd,Att 3rd,Tkl.1,Att,Tkl%,Lost,Blocks,Sh,Pass,Int,Tkl+Int,Clr,Err
0,0,1,Brenden Aaronson,Leeds United,26.4,45,18,16,22,7,15,46,32.6,31,43,3,40,5,50,6,1
1,1,2,George Abbott,Tottenham,0.0,0,0,0,0,0,0,0,,0,0,0,0,1,1,0,0
2,2,3,Che Adams,Southampton,22.1,17,13,7,8,2,7,12,58.3,5,13,4,9,4,21,22,0
3,3,4,Tyler Adams,Leeds United,24.0,89,46,44,35,10,50,77,64.9,27,48,8,40,35,124,29,0
4,4,5,Tosin Adarabioyo,Fulham,23.2,30,13,22,6,2,16,23,69.6,7,20,15,5,26,56,140,1
5,5,6,Nayef Aguerd,West Ham,17.7,27,18,18,8,1,13,20,65.0,7,26,24,2,18,45,79,2
6,6,7,Naouirou Ahamada,Crystal Palace,1.0,3,2,3,0,0,1,3,33.3,2,2,0,2,0,3,0,0
7,7,8,Rayan Aït Nouri,Wolves,12.0,33,20,25,7,1,9,15,60.0,6,3,0,3,9,42,28,0
8,8,9,Kristoffer Ajer,Brentford,8.5,11,8,5,4,2,9,16,56.3,7,6,5,1,7,18,22,0
9,9,10,Manuel Akanji,Manchester City,25.4,36,25,15,18,3,23,36,63.9,13,27,9,18,16,52,33,0
10,10,11,Nathan Aké,Manchester City,20.8,26,12,15,9,2,11,15,73.3,4,20,10,10,20,46,48,0
11,11,12,Marc Albrighton,Leicester City,2.6,4,1,0,2,2,1,8,12.5,7,6,2,4,1,5,5,0
12,12,13,Thiago Alcántara,Liverpool,13.9,43,24,20,21,2,14,23,60.9,9,15,3,12,21,64,13,2
13,13,14,Carlos Alcaraz,Southampton,11.4,10,5,2,7,1,6,22,27.3,16,14,5,9,1,11,11,0
14,14,15,Trent Alexander-Arnold,Liverpool,32.5,57,40,32,16,9,42,79,53.2,37,25,7,18,43,100,41,2
15,15,16,Alisson,Liverpool,37.0,0,0,0,0,0,0,3,0.0,3,3,0,3,0,0,20,0
16,16,17,Dele Alli,Everton,0.4,0,0,0,0,0,0,0,,0,0,0,0,0,0,0,0
17,17,18,Miguel Almirón,Newcastle Utd,27.7,46,30,16,19,11,18,42,42.9,24,25,2,23,10,56,17,0
18,18,19,Julián Álvarez,Manchester City,16.3,26,16,3,13,10,9,29,31.0,20,13,0,13,2,28,6,0
19,19,20,Daniel Amartey,Leicester City,17.9,19,8,13,5,1,12,14,85.7,2,24,17,7,8,27,71,0
20,20,21,Samuel Amo-Ameyaw,Southampton,0.0,0,0,0,0,0,0,1,0.0,1,0,0,0,0,0,0,0
21,21,22,Joachim Andersen,Crystal Palace,30.9,42,22,30,12,0,16,32,50.0,16,28,13,15,24,66,188,0
22,22,23,Elliot Anderson,Newcastle Utd,4.6,11,5,5,3,3,6,12,50.0,6,11,2,9,6,17,2,0
23,23,24,Jaidon Anthony,Bournemouth,14.0,30,17,15,9,6,8,24,33.3,16,30,3,27,10,40,19,0
24,24,25,Michail Antonio,West Ham,20.3,14,7,1,8,5,3,12,25.0,9,13,5,8,5,19,9,0
25,26,26,Antony,Manchester Utd,20.0,22,9,9,9,4,8,28,28.6,20,18,0,18,11,33,6,0
26,27,27,Cameron Archer,Aston Villa,0.5,0,0,0,0,0,0,0,,0,0,0,0,0,0,0,0
27,28,28,Alphonse Areola,West Ham,3.4,0,0,0,0,0,0,0,,0,0,0,0,0,0,0,0
28,29,29,Joe Aribo,Southampton,13.6,31,20,15,12,4,11,20,55.0,9,14,1,13,10,41,11,0
29,30,30,Adam Armstrong,Southampton,14.8,14,9,6,5,3,3,10,30.0,7,15,3,12,5,19,6,0
30,31,31,Stuart Armstrong,Southampton,15.6,32,21,15,13,4,14,39,35.9,25,18,0,18,10,42,9,1
31,32,32,Kepa Arrizabalaga,Chelsea,28.5,2,2,2,0,0,2,3,66.7,1,0,0,0,1,3,16,2
32,33,33,Pierre-Emerick Aubameyang,Chelsea,6.2,1,0,1,0,0,0,1,0.0,1,2,0,2,2,3,4,2
33,34,34,Ludwig Augustinsson,Aston Villa,0.9,1,1,1,0,0,0,0,,0,0,0,0,0,1,1,0
34,35,35,Serge Aurier,Nott'ham Forest,21.6,64,41,41,18,5,23,33,69.7,10,34,11,23,29,93,75,0
35,36,36,Taiwo Awoniyi,Nott'ham Forest,15.6,17,10,2,10,5,6,10,60.0,4,18,4,14,4,21,20,0
36,37,37,Yasin Ayari,Brighton,0.7,2,2,1,1,0,0,4,0.0,4,1,0,1,0,2,0,0
37,38,38,André Ayew,Nott'ham Forest,3.5,5,3,0,4,1,2,4,50.0,2,6,1,5,0,5,7,0
38,39,39,Jordan Ayew,Crystal Palace,30.2,66,41,23,20,23,21,53,39.6,32,35,4,31,15,81,31,0
39,40,40,Luke Ayling,Leeds United,22.8,66,37,42,15,9,42,85,49.4,43,34,11,23,26,92,52,2
40,41,41,César Azpilicueta,Chelsea,17.0,43,25,23,15,5,22,37,59.5,15,26,5,21,19,62,54,1
41,42,42,Benoît Badiashile,Chelsea,10.1,14,8,10,4,0,9,14,64.3,5,5,2,3,16,30,34,1
42,43,43,Leon Bailey,Aston Villa,21.9,14,6,6,7,1,5,20,25.0,15,13,0,13,6,20,12,0
43,44,44,Stefan Bajcetic,Liverpool,5.8,9,6,5,3,1,8,27,29.6,19,7,0,7,9,18,4,0
44,45,45,Dominic Ballard,Southampton,0.3,0,0,0,0,0,0,0,,0,0,0,0,1,1,0,0
45,46,46,Patrick Bamford,Leeds United,16.8,9,6,0,6,3,4,20,20.0,16,12,5,7,5,14,13,0
46,47,47,Shandon Baptiste,Brentford,6.9,15,9,6,6,3,7,17,41.2,10,10,2,8,7,22,10,0
47,48,48,Harvey Barnes,Leicester City,30.1,26,14,8,14,4,14,42,33.3,28,32,1,31,8,34,12,0
48,49,49,Gavin Bazunu,Southampton,32.0,1,0,1,0,0,1,1,100.0,0,0,0,0,1,2,24,2
49,50,50,Mads Bech Sørensen,Brentford,0.2,0,0,0,0,0,0,0,,0,0,0,0,1,1,1,0
50,52,51,Jan Bednarek,Southampton,18.6,27,21,20,7,0,12,16,75.0,4,38,27,11,49,76,87,0
51,53,52,Jan Bednarek,Aston Villa,1.1,3,3,0,3,0,1,1,100.0,0,3,1,2,2,5,5,0
52,54,53,Donny van de Beek,Manchester Utd,1.9,0,0,0,0,0,0,1,0.0,1,2,1,1,1,1,1,0
53,55,54,Asmir Begović,Everton,1.0,0,0,0,0,0,0,0,,0,0,0,0,0,0,1,0
54,56,55,Armel Bella Kotchap,Southampton,20.9,37,17,28,9,0,15,20,75.0,5,29,12,17,44,81,110,0
55,57,56,Saïd Benrahma,West Ham,23.0,25,15,11,7,7,11,27,40.7,16,23,1,22,9,34,13,0
56,58,57,Rodrigo Bentancur,Tottenham,16.7,45,28,15,21,9,16,28,57.1,12,28,15,13,20,65,22,0
57,59,58,Daniel Bentley,Wolves,2.0,1,1,1,0,0,1,1,100.0,0,0,0,0,0,1,0,0
58,60,59,Victor Bernth Kristiansen,Leicester City,9.9,38,23,18,16,4,22,30,73.3,8,16,4,12,3,41,26,0
59,61,60,Owen Bevan,Bournemouth,0.1,0,0,0,0,0,0,0,,0,0,0,0,0,0,0,0
60,62,61,Giulian Biancone,Nott'ham Forest,0.2,2,1,2,0,0,1,1,100.0,0,0,0,0,1,3,0,0
61,63,62,Philip Billing,Bournemouth,30.7,63,36,21,33,9,11,40,27.5,29,48,8,40,31,94,58,1
62,64,63,Yves Bissouma,Tottenham,11.2,16,13,6,6,4,2,7,28.6,5,15,6,9,12,28,10,0
63,65,64,Willy Boly,Nott'ham Forest,7.6,13,6,8,3,2,8,13,61.5,5,13,4,9,12,25,45,0
64,66,65,Sven Botman,Newcastle Utd,34.7,38,24,31,7,0,22,28,78.6,6,44,24,20,34,72,126,2
65,67,66,Jarrod Bowen,West Ham,35.9,39,16,14,11,14,16,57,28.1,41,47,9,38,36,75,25,0
66,68,67,James Bree,Southampton,4.1,5,3,4,1,0,3,4,75.0,1,3,1,2,6,11,11,0
67,69,68,Armando Broja,Chelsea,3.3,4,1,0,3,1,1,1,100.0,0,10,1,9,1,5,1,0
68,70,69,David Brooks,Bournemouth,1.9,1,0,1,0,0,0,1,0.0,1,2,0,2,2,3,5,0
69,71,70,Lewis Brunt,Leicester City,0.3,0,0,0,0,0,0,0,,0,0,0,0,0,0,2,0
70,72,71,Emi Buendía,Aston Villa,26.8,52,23,20,20,12,21,74,28.4,53,20,2,18,20,72,17,0
71,73,72,Hugo Bueno,Wolves,14.6,33,16,23,6,4,17,33,51.5,16,14,1,13,10,43,36,0
72,74,73,Facundo Buonanotte,Brighton,6.3,2,1,1,1,0,1,22,4.5,21,5,2,3,4,6,3,0
73,75,74,Dan Burn,Newcastle Utd,34.6,60,38,29,23,8,34,67,50.7,33,42,16,26,32,92,120,2
74,76,75,Cafú,Nott'ham Forest,0.1,0,0,0,0,0,0,0,,0,0,0,0,0,0,1,0
75,78,76,Moisés Caicedo,Brighton,34.9,100,50,41,47,12,40,68,58.8,28,43,7,36,56,156,31,3
76,79,77,Tom Cairney,Fulham,11.0,17,6,4,8,5,7,10,70.0,3,18,3,15,5,22,3,0
77,80,78,Duje Ćaleta-Car,Southampton,10.5,14,10,9,4,1,6,9,66.7,3,15,11,4,15,29,65,1
78,81,79,Dominic Calvert-Lewin,Everton,12.9,4,2,1,0,3,1,5,20.0,4,5,1,4,3,7,18,0
79,82,80,Chem Campbell,Wolves,0.8,2,1,1,1,0,0,1,0.0,1,2,0,2,1,3,0,0
80,83,81,João Cancelo,Manchester City,14.2,29,21,16,9,4,17,24,70.8,7,7,1,6,19,48,9,1
81,84,82,Thomas Cannon,Everton,0.3,0,0,0,0,0,0,0,,0,0,0,0,0,0,0,0
82,85,83,Sergi Canós,Brentford,0.9,0,0,0,0,0,0,2,0.0,2,3,1,2,0,0,1,0
83,86,84,Diego Carlos,Aston Villa,2.3,1,0,0,1,0,0,1,0.0,1,2,2,0,1,2,2,0
84,87,85,Fabio Carvalho,Liverpool,3.9,8,8,3,3,2,3,6,50.0,3,6,0,6,6,14,0,0
85,88,86,Casemiro,Manchester Utd,23.6,89,46,43,35,11,48,92,52.2,44,49,11,38,34,123,64,0
86,89,87,Matty Cash,Aston Villa,20.2,55,32,36,15,4,26,37,70.3,11,20,5,15,26,81,43,0
87,90,88,Timothy Castagne,Leicester City,36.2,87,44,53,27,7,41,84,48.8,43,50,13,37,43,130,110,0
88,91,89,Jonny Castro,Wolves,14.0,34,15,23,10,1,18,37,48.6,19,26,5,21,14,48,28,2
89,92,90,Julio César Enciso,Brighton,9.0,13,4,3,6,4,8,13,61.5,5,9,0,9,4,17,2,0
90,93,91,Nathaniel Chalobah,Fulham,0.1,1,1,1,0,0,1,1,100.0,0,0,0,0,0,1,2,0
91,94,92,Trevoh Chalobah,Chelsea,17.9,31,20,22,6,3,24,34,70.6,10,17,7,10,24,55,56,1
92,95,93,Calum Chambers,Aston Villa,3.9,9,6,7,2,0,6,8,75.0,2,5,4,1,7,16,10,1
93,96,94,Shea Charles,Manchester City,0.3,4,0,4,0,0,1,1,100.0,0,0,0,0,1,5,2,0
94,97,95,Ben Chilwell,Chelsea,15.6,21,17,12,8,1,13,25,52.0,12,21,2,19,18,39,26,0
95,98,96,Ryan Christie,Bournemouth,20.4,34,22,10,23,1,14,49,28.6,35,16,4,12,26,60,20,0
96,99,97,Carney Chukwuemeka,Chelsea,3.9,13,7,7,6,0,3,5,60.0,2,7,0,7,6,19,1,0
97,100,98,Bobby Clark,Liverpool,0.1,0,0,0,0,0,0,0,,0,2,0,2,0,0,0,0
98,101,99,Nathaniel Clyne,Crystal Palace,18.2,27,16,13,9,5,14,23,60.9,9,22,4,18,19,46,34,0
99,102,100,Conor Coady,Everton,23.3,14,9,8,6,0,7,15,46.7,8,21,17,4,14,28,88,3
100,104,101,Jack Colback,Nott'ham Forest,5.5,18,13,12,6,0,5,8,62.5,3,3,0,3,3,21,9,0
101,105,102,Séamus Coleman,Everton,18.4,35,26,21,10,4,19,29,65.5,10,14,7,7,22,57,58,2
102,106,103,Nathan Collins,Wolves,20.2,27,15,19,8,0,15,24,62.5,9,35,28,7,21,48,84,0
103,107,104,Levi Colwill,Brighton,13.6,8,7,4,4,0,4,9,44.4,5,5,3,2,15,23,37,1
104,108,105,Lewis Cook,Bournemouth,19.1,37,22,10,22,5,18,42,42.9,24,29,10,19,23,60,31,0
105,109,106,Steve Cook,Nott'ham Forest,10.6,8,4,4,4,0,5,7,71.4,2,16,11,5,12,20,51,0
106,110,107,Liam Cooper,Leeds United,15.8,38,23,27,9,2,23,36,63.9,13,16,8,8,34,72,57,3
107,111,108,Maxwel Cornet,West Ham,2.7,7,3,5,0,2,4,6,66.7,2,6,0,6,2,9,3,0
108,112,109,Diego Costa,Wolves,13.8,3,1,3,0,0,2,9,22.2,7,6,1,5,2,5,17,0
109,113,110,Vladimír Coufal,West Ham,23.7,58,31,37,15,6,36,51,70.6,15,24,6,18,38,96,70,0
110,114,111,Philippe Coutinho,Aston Villa,8.8,19,14,8,8,3,9,15,60.0,6,11,1,10,4,23,2,0
111,115,112,Conor Coventry,West Ham,0.0,0,0,0,0,0,0,0,,0,0,0,0,0,0,0,0
112,116,113,Matthew Craig,Tottenham,0.2,4,1,2,2,0,0,0,,0,0,0,0,0,4,0,0
113,117,114,Aaron Cresswell,West Ham,24.8,21,11,12,7,2,12,31,38.7,19,21,11,10,27,48,56,0
114,118,115,Marc Cucurella,Chelsea,18.6,66,33,40,15,11,30,60,50.0,30,28,8,20,16,82,48,1
115,119,116,Matheus Cunha,Wolves,10.7,7,4,0,5,2,2,10,20.0,8,15,3,12,9,16,11,0
116,120,117,Patson Daka,Leicester City,13.2,14,8,6,8,0,3,12,25.0,9,14,2,12,7,21,7,0
117,121,118,Diogo Dalot,Manchester Utd,23.9,54,41,40,13,1,33,45,73.3,12,25,7,18,37,91,55,2
118,122,119,Mikkel Damsgaard,Brentford,11.0,31,21,13,13,5,15,42,35.7,27,20,2,18,10,41,14,0
119,123,120,Danilo,Nott'ham Forest,10.8,18,7,7,9,2,6,25,24.0,19,26,6,20,9,27,19,0
120,124,121,Arnaut Danjuma,Tottenham,1.9,2,0,1,1,0,0,0,,0,1,0,1,0,2,0,0
121,125,122,Josh Dasilva,Brentford,15.4,18,9,6,6,6,6,16,37.5,10,22,6,16,5,23,7,1
122,126,123,Ben Davies,Tottenham,25.4,28,11,13,13,2,14,26,53.8,12,17,8,9,18,46,72,0
123,127,124,Tom Davies,Everton,6.0,15,9,5,9,1,7,14,50.0,7,10,1,9,4,19,7,1
124,128,125,Craig Dawson,West Ham,8.0,10,6,8,2,0,4,6,66.7,2,9,6,3,6,16,26,0
125,130,126,Craig Dawson,Wolves,15.7,9,6,6,3,0,4,7,57.1,3,31,23,8,12,21,74,2
126,131,127,Kevin De Bruyne,Manchester City,26.9,28,12,3,12,13,14,39,35.9,25,27,2,25,9,37,10,0
127,132,128,Siriki Dembélé,Bournemouth,1.2,3,1,2,1,0,0,1,0.0,1,1,0,1,1,4,1,0
128,133,129,Leander Dendoncker,Aston Villa,7.7,19,9,11,6,2,11,21,52.4,10,19,4,15,10,29,12,0
129,134,130,Leander Dendoncker,Wolves,2.4,4,2,0,3,1,2,3,66.7,1,2,0,2,9,13,4,0
130,135,131,Emmanuel Dennis,Nott'ham Forest,8.0,17,11,5,5,7,8,17,47.1,9,13,1,12,2,19,6,0
131,136,132,Halil Dervişoğlu,Brentford,0.1,0,0,0,0,0,0,1,0.0,1,0,0,0,0,0,0,0
132,137,133,Kiernan Dewsbury-Hall,Leicester City,25.6,53,29,14,34,5,19,47,40.4,28,55,13,42,28,81,21,0
133,138,134,Ibrahima Diallo,Southampton,9.1,25,15,14,10,1,8,14,57.1,6,11,1,10,6,31,11,0
134,139,135,Rúben Dias,Manchester City,22.2,21,13,10,10,1,11,18,61.1,7,21,13,8,18,39,56,1
135,140,136,Luis Díaz,Liverpool,11.1,17,11,4,8,5,8,15,53.3,7,8,0,8,6,23,2,0
136,141,137,Eric Dier,Tottenham,31.3,30,19,16,12,2,9,19,47.4,10,41,24,17,35,65,112,2
137,142,138,Lucas Digne,Aston Villa,16.7,30,12,20,9,1,20,33,60.6,13,18,5,13,18,48,45,0
138,143,139,Issa Diop,Fulham,22.4,28,19,18,9,1,17,32,53.1,15,24,17,7,35,63,86,0
139,144,140,Moussa Djenepo,Southampton,7.9,19,11,13,5,1,11,26,42.3,15,19,2,17,11,30,7,0
140,145,141,Ben Doak,Liverpool,0.3,3,2,1,2,0,1,1,100.0,0,1,0,1,0,3,0,0
141,146,142,Matt Doherty,Tottenham,7.4,16,10,12,3,1,8,10,80.0,2,11,6,5,8,24,14,1
142,147,143,Gabriel Dos Santos,Arsenal,37.9,48,30,29,15,4,18,27,66.7,9,49,26,23,32,80,125,2
143,148,144,Abdoulaye Doucouré,Everton,17.0,31,20,9,15,7,12,37,32.4,25,26,3,23,13,44,11,0
144,149,145,Cheick Doucouré,Crystal Palace,30.8,77,46,40,33,4,29,52,55.8,23,47,13,34,56,133,48,0
145,150,146,Flynn Downes,West Ham,8.5,16,9,4,10,2,6,12,50.0,6,15,2,13,7,23,6,0
146,151,147,Kami Doyle,Southampton,0.1,0,0,0,0,0,0,0,,0,0,0,0,0,0,0,0
147,152,148,Cody Drameh,Leeds United,0.8,5,4,0,4,1,2,3,66.7,1,0,0,0,1,6,1,0
148,153,149,Martin Dúbravka,Newcastle Utd,1.7,0,0,0,0,0,0,1,0.0,1,0,0,0,0,0,1,0
149,154,150,Shane Duffy,Fulham,0.2,0,0,0,0,0,0,0,,0,0,0,0,0,0,0,1
150,156,151,Lewis Dunk,Brighton,36.0,30,19,19,9,2,18,41,43.9,23,37,27,10,34,64,81,1
151,157,152,Jhon Durán,Aston Villa,1.5,2,2,0,1,1,1,4,25.0,3,0,0,0,2,4,2,0
152,158,153,Malcolm Ebiowei,Crystal Palace,0.4,1,1,1,0,0,0,1,0.0,1,2,0,2,0,1,0,0
153,159,154,Ederson,Manchester City,35.0,3,1,3,0,0,1,2,50.0,1,0,0,0,1,4,10,2
154,160,155,Odsonne Édouard,Crystal Palace,20.0,25,13,7,12,6,7,13,53.8,6,17,5,12,3,28,22,0
155,161,156,Samuel Edozie,Southampton,6.3,17,10,6,10,1,3,8,37.5,5,7,0,7,6,23,6,0
156,162,157,Anthony Elanga,Manchester Utd,4.7,3,0,0,2,1,1,2,50.0,1,4,0,4,2,5,4,0
157,163,158,Harvey Elliott,Liverpool,17.9,27,18,6,12,9,9,36,25.0,27,26,1,25,15,42,8,0
158,164,159,Mohamed Elneny,Arsenal,1.3,1,1,1,0,0,1,1,100.0,0,0,0,0,0,1,0,0
159,165,160,Mohamed Elyounoussi,Southampton,24.1,46,28,22,20,4,19,43,44.2,24,40,3,37,27,73,37,0
160,166,161,Emerson,Tottenham,19.3,54,33,38,12,4,27,40,67.5,13,17,3,14,18,72,75,0
161,167,162,Christian Eriksen,Manchester Utd,22.8,22,18,10,7,5,10,32,31.3,22,23,9,14,11,33,20,1
162,168,163,Pervis Estupiñán,Brighton,29.7,61,31,36,19,6,35,60,58.3,25,30,8,22,37,98,37,1
163,169,164,Jonny Evans,Leicester City,11.7,13,5,12,1,0,7,11,63.6,4,15,11,4,18,31,51,0
164,170,165,Eberechi Eze,Crystal Palace,29.3,42,24,17,18,7,18,38,47.4,20,22,0,22,13,55,10,0
165,171,166,Łukasz Fabiański,West Ham,34.6,2,0,2,0,0,1,2,50.0,1,1,0,1,0,2,10,1
166,172,167,Fabinho,Liverpool,29.7,65,38,18,40,7,24,62,38.7,38,38,11,27,37,102,40,0
167,173,168,Wout Faes,Leicester City,31.0,56,33,28,26,2,28,44,63.6,16,53,37,16,41,97,113,2
168,174,169,Felipe,Nott'ham Forest,15.8,42,23,29,13,0,24,41,58.5,17,34,13,21,36,78,90,0
169,175,170,João Félix,Chelsea,10.5,14,7,5,6,3,4,12,33.3,8,3,0,3,1,15,1,1
170,176,171,Evan Ferguson,Brighton,10.6,6,3,1,3,2,1,7,14.3,6,11,1,10,2,8,6,0
171,177,172,Bruno Fernandes,Manchester Utd,36.8,68,42,24,25,19,30,71,42.3,41,37,5,32,25,93,40,1
172,178,173,Enzo Fernández,Chelsea,17.2,45,27,25,17,3,21,56,37.5,35,32,2,30,16,61,12,1
173,179,174,Roberto Firmino,Liverpool,13.5,17,12,2,12,3,4,21,19.0,17,16,1,15,7,24,2,0
174,180,175,Junior Firpo,Leeds United,15.2,47,25,27,15,5,24,46,52.2,22,23,7,16,24,71,40,0
175,182,176,Phil Foden,Manchester City,20.5,16,10,9,5,2,8,19,42.1,11,25,2,23,5,21,12,0
176,183,177,Datro Fofana,Chelsea,0.8,3,1,1,1,1,1,1,100.0,0,1,0,1,0,3,0,0
177,184,178,Wesley Fofana,Leicester City,2.0,4,2,1,2,1,1,3,33.3,2,1,1,0,9,13,5,0
178,185,179,Wesley Fofana,Chelsea,13.1,30,18,19,7,4,13,26,50.0,13,17,10,7,20,50,33,2
179,186,180,Pablo Fornals,West Ham,16.7,30,15,9,12,9,13,34,38.2,21,16,2,14,14,44,9,0
180,187,181,Adam Forshaw,Leeds United,5.3,12,9,5,7,0,7,17,41.2,10,9,1,8,4,16,2,0
181,188,182,Fraser Forster,Tottenham,13.5,1,0,1,0,0,0,0,,0,1,0,1,0,1,3,1
182,189,183,Tyrese Francois,Fulham,0.0,0,0,0,0,0,0,0,,0,0,0,0,0,0,1,0
183,190,184,Ryan Fraser,Newcastle Utd,3.5,2,2,0,0,2,2,5,40.0,3,3,1,2,0,2,3,0
184,191,185,Fred,Manchester Utd,13.9,47,30,24,20,3,15,38,39.5,23,38,2,36,19,66,19,0
185,192,186,Ryan Fredericks,Bournemouth,5.9,3,2,2,0,1,1,4,25.0,3,7,2,5,1,4,27,0
186,193,187,Remo Freuler,Nott'ham Forest,24.0,43,23,23,15,5,19,43,44.2,24,36,9,27,29,72,45,0
187,194,188,Cody Gakpo,Liverpool,16.2,26,15,4,13,9,13,38,34.2,25,13,1,12,4,30,2,0
188,195,189,Conor Gallagher,Chelsea,18.0,46,33,17,19,10,10,37,27.0,27,41,10,31,23,69,18,1
189,196,190,Idrissa Gana Gueye,Everton,28.6,97,57,49,35,13,31,60,51.7,29,50,12,38,56,153,34,3
190,197,191,Alejandro Garnacho,Manchester Utd,6.3,5,2,2,0,3,1,11,9.1,10,5,0,5,5,10,3,0
191,198,192,James Garner,Everton,8.9,16,13,4,8,4,9,19,47.4,10,9,1,8,12,28,13,0
192,199,193,David de Gea,Manchester Utd,38.0,0,0,0,0,0,0,1,0.0,1,0,0,0,1,1,15,3
193,200,194,Joe Gelhardt,Leeds United,2.4,6,2,1,3,2,3,5,60.0,2,5,0,5,0,6,4,0
194,201,195,Saman Ghoddos,Brentford,1.5,2,1,0,1,1,1,3,33.3,2,5,1,4,4,6,2,0
195,202,196,Morgan Gibbs-White,Wolves,2.0,3,1,3,0,0,2,3,66.7,1,2,0,2,1,4,3,0
196,203,197,Morgan Gibbs-White,Nott'ham Forest,33.0,26,14,7,7,12,11,32,34.4,21,23,4,19,14,40,15,0
197,204,198,Bryan Gil,Tottenham,1.6,3,1,3,0,0,0,3,0.0,3,3,0,3,1,4,1,0
198,205,199,Billy Gilmour,Brighton,5.6,5,2,2,2,1,2,8,25.0,6,5,2,3,6,11,5,0
199,206,200,Degnand Gnonto,Leeds United,15.0,27,17,7,15,5,10,30,33.3,20,24,1,23,5,32,7,0
200,208,201,Ben Godfrey,Everton,8.9,20,11,13,5,2,11,29,37.9,18,12,6,6,8,28,33,1
201,209,202,João Gomes,Wolves,7.3,29,13,14,14,1,13,23,56.5,10,12,3,9,4,33,11,0
202,210,203,Toti Gomes,Wolves,10.9,15,9,11,4,0,9,13,69.2,4,16,8,8,11,26,51,0
203,211,204,Joe Gomez,Liverpool,16.3,28,21,15,11,2,11,19,57.9,8,17,11,6,24,52,51,2
204,212,205,Sergio Gómez,Manchester City,3.9,9,4,6,1,2,5,8,62.5,3,5,3,2,2,11,9,1
205,213,206,Anthony Gordon,Newcastle Utd,5.4,14,12,5,7,2,9,20,45.0,11,9,1,8,2,16,1,1
206,214,207,Anthony Gordon,Everton,12.2,34,22,17,10,7,8,23,34.8,15,19,0,19,4,38,11,0
207,215,208,Demarai Gray,Everton,27.9,33,24,9,14,10,17,31,54.8,14,23,3,20,13,46,18,0
208,216,209,Jack Grealish,Manchester City,22.8,25,16,10,12,3,13,22,59.1,9,17,3,14,7,32,9,0
209,217,210,Sam Greenwood,Leeds United,4.7,15,7,7,8,0,8,21,38.1,13,10,2,8,1,16,1,0
210,218,211,Pascal Groß,Brighton,36.0,59,38,23,27,9,25,55,45.5,30,32,10,22,13,72,21,1
211,219,212,Vicente Guaita,Crystal Palace,27.0,0,0,0,0,0,0,0,,0,0,0,0,0,0,9,1
212,220,213,Gonçalo Guedes,Wolves,7.9,8,6,4,3,1,5,8,62.5,3,4,0,4,1,9,2,0
213,221,214,Marc Guéhi,Crystal Palace,37.0,52,27,39,11,2,26,42,61.9,16,45,24,21,45,97,134,3
214,222,215,Bruno Guimarães,Newcastle Utd,30.3,78,40,27,46,5,38,65,58.5,27,28,4,24,36,114,22,1
215,223,216,İlkay Gündoğan,Manchester City,26.1,30,18,7,13,10,12,33,36.4,21,18,3,15,20,50,13,0
216,224,217,Darko Gyabi,Leeds United,0.1,2,2,1,1,0,0,0,,0,2,0,2,0,2,0,0
217,225,218,Erling Haaland,Manchester City,30.8,3,2,0,2,1,1,5,20.0,4,12,4,8,3,6,14,0
218,226,219,Lewis Hall,Chelsea,7.3,23,12,19,4,0,15,22,68.2,7,8,0,8,11,34,11,1
219,227,220,Luke Harris,Fulham,0.1,0,0,0,0,0,0,0,,0,0,0,0,0,0,0,0
220,228,221,Jack Harrison,Leeds United,30.1,41,17,5,15,21,12,52,23.1,40,47,2,45,22,63,25,0
221,229,222,Kai Havertz,Chelsea,28.5,34,16,4,20,10,10,30,33.3,20,28,0,28,7,41,41,0
222,230,223,Jan Paul van Hecke,Brighton,3.3,8,6,3,4,1,5,5,100.0,0,8,5,3,6,14,9,0
223,231,224,Hwang Hee-chan,Wolves,12.6,20,9,7,8,5,6,19,31.6,13,18,2,16,5,25,5,0
224,232,225,Dean Henderson,Nott'ham Forest,18.0,0,0,0,0,0,0,0,,0,0,0,0,0,0,12,1
225,234,226,Jordan Henderson,Liverpool,23.0,32,23,10,18,4,15,36,41.7,21,21,3,18,21,53,16,1
226,235,227,Wayne Hennessey,Nott'ham Forest,3.0,1,0,1,0,0,1,1,100.0,0,0,0,0,0,1,2,0
227,236,228,Rico Henry,Brentford,36.0,57,31,20,28,9,22,41,53.7,19,29,8,21,30,87,84,1
228,237,229,Son Heung-min,Tottenham,32.1,24,12,7,8,9,9,30,30.0,21,23,2,21,13,37,6,0
229,238,230,Aaron Hickey,Brentford,21.3,38,26,27,11,0,18,32,56.3,14,18,7,11,17,55,32,1
230,239,231,Jack Hinshelwood,Brighton,0.0,1,0,1,0,0,0,0,,0,0,0,0,0,1,0,0
231,240,232,Joseph Hodge,Wolves,1.9,5,2,1,3,1,3,4,75.0,1,5,0,5,0,5,2,1
232,241,233,Rob Holding,Arsenal,6.3,8,5,4,4,0,3,6,50.0,3,6,5,1,3,11,27,1
233,242,234,Mason Holgate,Everton,5.6,11,7,8,3,0,3,11,27.3,8,7,3,4,7,18,28,0
234,243,235,Will Hughes,Crystal Palace,9.4,29,16,11,16,2,11,20,55.0,9,16,7,9,16,45,9,0
235,244,236,Omari Hutchinson,Chelsea,0.3,0,0,0,0,0,0,0,,0,0,0,0,1,1,0,0
236,245,237,Pierre Højbjerg,Tottenham,34.8,56,30,28,22,6,26,67,38.8,41,46,17,29,49,105,64,1
237,246,238,Kelechi Iheanacho,Leicester City,12.5,7,2,0,3,4,3,10,30.0,7,9,1,8,0,7,8,0
238,247,239,Danny Ings,West Ham,8.6,9,8,0,4,5,5,14,35.7,9,8,2,6,3,12,5,0
239,248,240,Danny Ings,Aston Villa,9.2,10,5,1,6,3,1,6,16.7,5,12,1,11,1,11,11,0
240,249,241,Alexander Isak,Newcastle Utd,16.9,18,8,4,7,7,10,28,35.7,18,21,2,19,4,22,8,0
241,250,242,Daniel Iversen,Leicester City,12.0,0,0,0,0,0,0,0,,0,0,0,0,0,0,6,1
242,251,243,Alex Iwobi,Everton,37.5,69,37,37,28,4,33,65,50.8,32,41,2,39,25,94,29,0
243,252,244,Daniel James,Leeds United,2.2,6,2,1,3,2,3,6,50.0,3,4,0,4,2,8,2,0
244,253,245,Daniel James,Fulham,6.9,9,5,4,4,1,4,8,50.0,4,5,1,4,1,10,5,0
245,254,246,Reece James,Chelsea,13.8,31,20,10,18,3,15,19,78.9,4,17,2,15,12,43,23,0
246,255,247,Vitaly Janelt,Brentford,24.5,54,27,20,24,10,21,49,42.9,28,29,9,20,29,83,26,0
247,256,248,Pontus Jansson,Brentford,8.0,5,3,4,1,0,3,5,60.0,2,13,9,4,9,14,38,0
248,257,249,Mathias Jensen,Brentford,31.1,70,35,28,30,12,34,97,35.1,63,54,5,49,32,102,24,1
249,258,250,Gabriel Jesus,Arsenal,22.9,33,25,16,8,9,15,31,48.4,16,27,3,24,11,44,15,1
250,260,251,Raúl Jiménez,Wolves,9.4,9,6,3,5,1,3,6,50.0,3,9,0,9,0,9,8,0
251,261,252,Joelinton,Newcastle Utd,29.6,70,49,36,26,8,26,62,41.9,36,52,7,45,48,118,39,0
252,262,253,Ben Johnson,West Ham,9.6,20,14,12,4,4,12,18,66.7,6,12,4,8,9,29,28,1
253,263,254,Brennan Johnson,Nott'ham Forest,32.6,34,20,18,8,8,8,28,28.6,20,30,1,29,5,39,7,1
254,264,255,Sam Johnstone,Crystal Palace,9.0,0,0,0,0,0,0,0,,0,0,0,0,0,0,5,0
255,265,256,Curtis Jones,Liverpool,11.5,34,17,8,12,14,18,31,58.1,13,12,2,10,3,37,9,0
256,266,257,Jorginho,Arsenal,9.5,18,13,6,10,2,5,24,20.8,19,7,2,5,9,27,8,0
257,267,258,Jorginho,Chelsea,14.2,42,23,22,14,6,22,46,47.8,24,18,3,15,21,63,7,0
258,268,259,Mateo Joseph,Leeds United,0.3,0,0,0,0,0,0,0,,0,1,0,1,0,0,1,0
259,269,260,Diogo Jota,Liverpool,12.6,23,15,8,8,7,12,37,32.4,25,5,0,5,3,26,11,0
260,270,261,Hamed Junior Traorè,Bournemouth,4.7,17,11,5,9,3,6,18,33.3,12,9,0,9,2,19,1,0
261,271,262,James Justin,Leicester City,13.9,20,18,7,12,1,9,14,64.3,5,24,6,18,15,35,47,0
262,272,263,Mathias Jørgensen,Brentford,12.3,17,8,9,8,0,9,21,42.9,12,19,12,7,16,33,39,1
263,273,264,Sasa Kalajdzic,Wolves,0.5,0,0,0,0,0,0,0,,0,0,0,0,1,1,0,0
264,274,265,Boubacar Kamara,Aston Villa,19.7,58,25,25,23,10,27,56,48.2,29,38,12,26,19,77,24,2
265,275,266,Harry Kane,Tottenham,37.8,15,12,1,6,8,7,21,33.3,14,27,7,20,2,17,18,0
266,276,267,N'Golo Kanté,Chelsea,5.8,16,10,4,10,2,4,8,50.0,4,11,0,11,6,22,2,0
267,277,268,Michael Keane,Everton,10.9,7,4,5,2,0,5,8,62.5,3,12,7,5,14,21,55,1
268,278,269,Neeskens Kebano,Fulham,8.5,17,9,8,6,3,9,17,52.9,8,14,0,14,1,18,8,0
269,279,270,Thilo Kehrer,West Ham,24.8,43,24,25,14,4,21,44,47.7,23,16,6,10,34,77,76,1
270,280,271,Naby Keïta,Liverpool,3.3,5,4,2,3,0,1,4,25.0,3,1,0,1,2,7,3,0
271,281,272,Caoimhín Kelleher,Liverpool,1.0,0,0,0,0,0,0,0,,0,0,0,0,0,0,0,0
272,282,273,Lloyd Kelly,Bournemouth,22.7,33,18,23,9,1,13,19,68.4,6,26,15,11,26,59,101,1
273,283,274,Max Kilman,Wolves,36.7,36,20,26,9,1,16,30,53.3,14,70,42,28,19,55,164,1
274,284,275,Jakub Kiwior,Arsenal,4.7,7,5,6,1,0,5,8,62.5,3,5,3,2,6,13,10,0
275,286,276,Mateusz Klich,Leeds United,3.1,12,8,3,4,5,7,13,53.8,6,4,0,4,0,12,1,0
276,287,277,Robin Koch,Leeds United,35.3,53,30,32,16,5,24,56,42.9,32,44,21,23,43,96,152,1
277,288,278,Ibrahima Konaté,Liverpool,17.2,38,26,25,13,0,16,27,59.3,11,12,5,7,26,64,61,4
278,289,279,Ezri Konsa,Aston Villa,36.9,42,20,25,15,2,18,26,69.2,8,41,23,18,26,68,120,3
279,290,280,Kalidou Koulibaly,Chelsea,20.0,45,31,34,8,3,26,40,65.0,14,30,13,17,29,74,77,0
280,291,281,Cheikhou Kouyaté,Nott'ham Forest,9.8,29,21,18,8,3,9,13,69.2,4,14,2,12,10,39,24,0
281,292,282,Mateo Kovačić,Chelsea,19.0,36,24,16,14,6,14,36,38.9,22,10,1,9,19,55,16,0
282,293,283,Emil Krafth,Newcastle Utd,0.0,0,0,0,0,0,0,0,,0,0,0,0,0,0,0,0
283,294,284,Dejan Kulusevski,Tottenham,23.0,38,15,23,7,8,16,44,36.4,28,19,0,19,13,51,7,0
284,295,285,Layvin Kurzawa,Fulham,1.5,3,2,1,1,1,3,3,100.0,0,1,1,0,2,5,4,0
285,296,286,Adam Lallana,Brighton,8.0,9,4,6,2,1,0,7,0.0,7,6,0,6,2,11,1,0
286,297,287,Tariq Lamptey,Brighton,5.0,11,6,6,4,1,5,7,71.4,2,7,3,4,7,18,2,0
287,298,288,Manuel Lanzini,West Ham,2.8,2,2,1,1,0,2,6,33.3,4,2,0,2,2,4,0,0
288,299,289,Aymeric Laporte,Manchester City,11.0,11,8,6,4,1,7,11,63.6,4,10,4,6,3,14,30,1
289,300,290,Juan Larios,Southampton,1.7,7,6,6,1,0,5,5,100.0,0,2,0,2,3,10,4,0
290,301,291,Jamaal Lascelles,Newcastle Utd,2.4,1,0,1,0,0,1,1,100.0,0,3,2,1,0,1,17,0
291,302,292,Roméo Lavia,Southampton,24.7,60,35,27,29,4,21,53,39.6,32,47,11,36,33,93,23,1
292,303,293,Dexter Lembikisa,Wolves,0.3,0,0,0,0,0,0,0,,0,0,0,0,0,0,0,0
293,304,294,Mario Lemina,Wolves,14.4,38,24,22,13,3,20,38,52.6,18,26,8,18,14,52,24,1
294,305,295,Clément Lenglet,Tottenham,22.4,38,23,18,15,5,16,34,47.1,18,26,11,15,18,56,68,2
295,306,296,Bernd Leno,Fulham,36.0,0,0,0,0,0,0,2,0.0,2,0,0,0,0,0,18,0
296,307,297,Jefferson Lerma,Bournemouth,36.1,50,30,23,23,4,20,45,44.4,25,32,15,17,47,97,91,1
297,308,298,Jamal Lewis,Newcastle Utd,0.1,0,0,0,0,0,0,0,,0,0,0,0,0,0,0,0
298,309,299,Rico Lewis,Manchester City,10.0,16,9,9,5,2,6,11,54.5,5,8,4,4,6,22,13,1
299,310,300,Keane Lewis-Potter,Brentford,3.6,1,0,0,1,0,0,0,,0,5,1,4,0,1,2,0
300,312,301,Victor Lindelöf,Manchester Utd,15.2,22,17,10,9,3,9,17,52.9,8,18,9,9,21,43,63,1
301,313,302,Jesse Lingard,Nott'ham Forest,10.3,4,4,2,2,0,1,7,14.3,6,11,0,11,5,9,4,0
302,314,303,Valentino Livramento,Southampton,0.3,2,1,2,0,0,0,0,,0,0,0,0,2,4,3,0
303,315,304,Diego Llorente,Leeds United,7.2,13,10,8,5,0,4,8,50.0,4,6,2,4,15,28,24,2
304,316,305,Hugo Lloris,Tottenham,24.5,1,1,1,0,0,1,3,33.3,2,0,0,0,1,2,13,4
305,317,306,Renan Lodi,Nott'ham Forest,24.6,52,39,38,8,6,33,66,50.0,33,25,6,19,33,85,74,0
306,318,307,Ruben Loftus-Cheek,Chelsea,17.1,25,14,8,14,3,12,21,57.1,9,15,2,13,12,37,23,0
307,319,308,Sean Longstaff,Newcastle Utd,28.0,42,21,16,20,6,20,52,38.5,32,35,8,27,16,58,23,0
308,320,309,Jamal Lowe,Bournemouth,0.1,0,0,0,0,0,0,0,,0,0,0,0,0,0,0,0
309,321,310,Douglas Luiz,Aston Villa,32.5,73,42,31,32,10,30,63,47.6,33,36,7,29,40,113,27,2
310,322,311,Saša Lukić,Fulham,4.6,8,3,1,4,3,3,7,42.9,4,6,2,4,5,13,3,0
311,323,312,Lyanco,Southampton,13.1,24,16,15,9,0,12,18,66.7,6,30,25,5,20,44,65,2
312,324,313,Alexis Mac Allister,Brighton,32.1,70,39,22,40,8,34,70,48.6,36,26,2,24,22,92,10,1
313,325,314,James Maddison,Leicester City,27.6,51,26,25,19,7,19,50,38.0,31,19,1,18,13,64,6,1
314,326,315,Noni Madueke,Chelsea,7.1,12,8,5,4,3,6,13,46.2,7,13,2,11,4,16,7,0
315,327,316,Harry Maguire,Manchester Utd,8.5,8,6,6,1,1,4,5,80.0,1,18,11,7,13,21,41,0
316,328,317,Riyad Mahrez,Manchester City,21.3,30,14,8,13,9,13,38,34.2,25,27,1,26,9,39,5,0
317,329,318,Kobbie Mainoo,Manchester Utd,0.1,0,0,0,0,0,0,0,,0,1,1,0,0,0,0,0
318,330,319,Ainsley Maitland-Niles,Southampton,15.6,45,24,23,18,4,28,44,63.6,16,28,7,21,22,67,45,1
319,331,320,Tyrell Malacia,Manchester Utd,15.5,46,33,33,12,1,14,25,56.0,11,13,3,10,25,71,49,0
320,332,321,Orel Mangala,Nott'ham Forest,17.2,28,20,16,10,2,12,29,41.4,17,21,7,14,23,51,15,0
321,333,322,Javier Manquillo,Newcastle Utd,0.4,3,2,2,1,0,2,2,100.0,0,1,0,1,1,4,1,0
322,334,323,Sekou Mara,Southampton,6.2,14,10,5,8,1,3,9,33.3,6,11,0,11,1,15,5,0
323,335,324,Solly March,Brighton,30.2,53,31,16,17,20,8,28,28.6,20,34,3,31,24,77,32,0
324,336,325,Emiliano Marcondes,Bournemouth,0.1,0,0,0,0,0,0,0,,0,0,0,0,0,0,1,0
325,338,326,Marquinhos,Arsenal,0.0,0,0,0,0,0,0,0,,0,0,0,0,0,0,0,0
326,339,327,Anthony Martial,Manchester Utd,10.9,5,3,0,2,3,1,4,25.0,3,11,2,9,1,6,4,0
327,340,328,Martinelli,Arsenal,31.0,31,18,13,12,6,9,22,40.9,13,24,1,23,9,40,14,0
328,341,329,Emiliano Martínez,Aston Villa,34.9,0,0,0,0,0,0,2,0.0,2,0,0,0,1,1,23,1
329,342,330,Lisandro Martínez,Manchester Utd,23.5,54,28,33,18,3,30,43,69.8,13,51,27,24,33,87,103,0
330,343,331,Pape Matar Sarr,Tottenham,2.4,7,6,4,2,1,4,8,50.0,4,3,2,1,6,13,6,0
331,344,332,Jean-Philippe Mateta,Crystal Palace,8.6,7,1,2,4,1,1,3,33.3,2,3,1,2,3,10,18,0
332,345,333,Joël Matip,Liverpool,12.1,14,8,12,2,0,11,23,47.8,12,8,3,5,21,35,45,3
333,346,334,Neal Maupay,Everton,12.4,11,5,3,4,4,2,4,50.0,2,8,0,8,5,16,0,0
334,347,335,Kevin Mbabu,Fulham,1.6,3,2,2,1,0,1,3,33.3,2,2,0,2,3,6,3,0
335,348,336,Bryan Mbeumo,Brentford,32.3,26,18,5,13,8,8,42,19.0,34,24,1,23,13,39,21,0
336,349,337,James McArthur,Crystal Palace,0.6,1,1,1,0,0,1,1,100.0,0,2,1,1,1,2,2,0
337,350,338,Alex McCarthy,Southampton,6.0,0,0,0,0,0,0,1,0.0,1,0,0,0,1,1,3,1
338,351,339,John McGinn,Aston Villa,29.9,66,36,27,29,10,34,71,47.9,37,43,4,39,24,90,19,0
339,352,340,Scott McKenna,Nott'ham Forest,17.5,12,7,7,3,2,6,10,60.0,4,20,14,6,12,24,85,1
340,353,341,Weston McKennie,Leeds United,16.0,30,13,5,18,7,10,29,34.5,19,22,3,19,22,52,26,0
341,354,342,Dwight McNeil,Everton,27.8,64,41,35,14,15,27,62,43.5,35,46,7,39,31,95,41,0
342,355,343,Scott McTominay,Manchester Utd,12.9,32,19,16,10,6,13,22,59.1,9,15,6,9,14,46,45,0
343,356,344,Ben Mee,Brentford,36.3,45,24,28,13,4,20,37,54.1,17,54,42,12,48,93,122,1
344,357,345,Edouard Mendy,Chelsea,9.5,0,0,0,0,0,0,0,,0,0,0,0,0,0,3,3
345,358,346,Nampalys Mendy,Leicester City,8.4,13,9,7,6,0,8,15,53.3,7,20,4,16,13,26,2,0
346,359,347,Chris Mepham,Bournemouth,24.4,45,22,37,8,0,19,30,63.3,11,40,27,13,30,75,152,0
347,360,348,Illan Meslier,Leeds United,34.0,2,1,2,0,0,2,4,50.0,2,0,0,0,1,3,30,3
348,361,349,Alexander Mighten,Nott'ham Forest,0.1,0,0,0,0,0,0,1,0.0,1,0,0,0,0,0,0,0
349,362,350,Lewis Miley,Newcastle Utd,0.2,0,0,0,0,0,0,0,,0,1,0,1,0,0,0,0
350,364,351,Luka Milivojević,Crystal Palace,5.7,13,7,7,4,2,7,10,70.0,3,13,4,9,12,25,10,0
351,365,352,James Milner,Liverpool,10.1,26,16,11,11,4,15,34,44.1,19,14,2,12,12,38,15,0
352,366,353,Yerry Mina,Everton,6.6,15,8,9,6,0,9,11,81.8,2,7,4,3,6,21,28,0
353,367,354,Tyrone Mings,Aston Villa,35.0,15,7,10,5,0,9,20,45.0,11,40,21,19,54,69,163,2
354,368,355,Tyrick Mitchell,Crystal Palace,32.1,71,49,43,23,5,30,53,56.6,23,48,11,37,42,113,78,0
355,369,356,Kaoru Mitoma,Brighton,25.8,44,27,15,16,13,20,41,48.8,21,25,0,25,17,61,10,0
356,370,357,Aleksandar Mitrović,Fulham,22.3,14,7,8,4,2,5,12,41.7,7,22,5,17,3,17,20,1
357,371,358,Kieffer Moore,Bournemouth,14.2,14,11,2,9,3,5,16,31.3,11,12,5,7,1,15,26,0
358,372,359,Andrew Moran,Brighton,0.1,0,0,0,0,0,0,0,,0,1,0,1,0,0,0,0
359,373,360,Álex Moreno,Aston Villa,14.8,23,14,15,5,3,13,36,36.1,23,18,3,15,7,30,37,2
360,374,361,Mason Mount,Chelsea,18.3,33,19,6,16,11,14,27,51.9,13,24,6,18,8,41,9,0
361,375,362,Lucas Moura,Tottenham,1.7,8,5,1,3,4,1,4,25.0,3,0,0,0,2,10,1,1
362,376,363,João Moutinho,Wolves,19.8,51,30,24,21,6,19,46,41.3,27,22,6,16,18,69,20,0
363,377,364,Divin Mubama,West Ham,0.4,1,1,1,0,0,0,0,,0,0,0,0,0,1,0,0
364,378,365,Mykhailo Mudryk,Chelsea,7.3,11,9,2,4,5,4,13,30.8,9,7,1,6,0,11,3,0
365,379,366,Jacob Murphy,Newcastle Utd,13.9,15,7,3,8,4,8,20,40.0,12,17,0,17,7,22,3,0
366,380,367,Enock Mwepu,Brighton,2.4,10,5,1,6,3,3,4,75.0,1,3,1,2,1,11,1,0
367,381,368,Vitaliy Mykolenko,Everton,29.5,58,34,36,19,3,28,51,54.9,23,50,16,34,46,104,99,0
368,382,369,Keylor Navas,Nott'ham Forest,17.0,0,0,0,0,0,0,0,,0,0,0,0,1,1,11,1
369,383,370,Wilfred Ndidi,Leicester City,18.7,61,42,34,24,3,17,43,39.5,26,32,14,18,38,99,48,3
370,384,371,Reiss Nelson,Arsenal,2.4,4,1,2,1,1,2,4,50.0,2,3,0,3,0,4,4,0
371,385,372,Neto,Bournemouth,26.5,3,1,3,0,0,3,3,100.0,0,0,0,0,0,3,10,3
372,386,373,Pedro Neto,Wolves,10.7,11,6,4,2,5,7,17,41.2,10,5,1,4,4,15,4,0
373,387,374,Rúben Neves,Wolves,33.5,79,43,31,33,15,32,74,43.2,42,59,22,37,50,129,85,1
374,388,375,Moussa Niakhate,Nott'ham Forest,12.9,18,9,15,3,0,11,22,50.0,11,18,8,10,19,37,60,0
375,390,376,Rasmus Nissen,Leeds United,21.8,62,35,35,21,6,42,76,55.3,34,32,14,18,35,97,61,0
376,391,377,Eddie Nketiah,Arsenal,12.1,13,9,6,2,5,2,8,25.0,6,7,1,6,1,14,7,0
377,392,378,Matheus Nunes,Wolves,27.4,67,43,36,22,9,28,61,45.9,33,35,4,31,16,83,35,2
378,393,379,Darwin Núñez,Liverpool,18.8,11,5,2,4,5,4,17,23.5,13,10,0,10,3,14,13,0
379,394,380,Ethan Nwaneri,Arsenal,0.0,0,0,0,0,0,0,0,,0,1,0,1,0,0,0,0
380,395,381,Christian Nørgaard,Brentford,19.6,52,30,21,29,2,18,48,37.5,30,32,9,23,34,86,41,2
381,396,382,Lewis O'Brien,Nott'ham Forest,6.5,16,9,4,11,1,6,12,50.0,6,13,2,11,5,21,9,0
382,397,383,Odeluga Offiah,Brighton,0.3,1,1,1,0,0,0,2,0.0,2,0,0,0,0,1,1,0
383,398,384,Angelo Ogbonna,West Ham,13.7,11,4,7,4,0,5,10,50.0,5,11,7,4,17,28,74,1
384,399,385,Michael Olise,Crystal Palace,30.5,58,34,28,26,4,25,60,41.7,35,46,1,45,26,84,17,0
385,400,386,Robin Olsen,Aston Villa,3.1,0,0,0,0,0,0,2,0.0,2,0,0,0,0,0,1,0
386,401,387,Amadou Onana,Everton,27.6,72,43,24,42,6,30,42,71.4,12,25,6,19,37,109,39,0
387,402,388,Josh Onomah,Fulham,0.2,1,0,1,0,0,0,0,,0,1,0,1,0,1,0,0
388,403,389,Paul Onuachu,Southampton,4.5,3,2,1,1,1,1,3,33.3,2,4,1,3,0,3,4,0
389,404,390,Frank Onyeka,Brentford,9.4,19,14,11,7,1,10,25,40.0,15,16,3,13,10,29,16,0
390,405,391,Mislav Oršić,Southampton,0.1,1,1,1,0,0,0,0,,0,0,0,0,0,1,0,0
391,406,392,Stefan Ortega,Manchester City,3.0,0,0,0,0,0,0,0,,0,0,0,0,0,0,0,0
392,407,393,Dango Ouattara,Bournemouth,13.8,28,15,20,6,2,13,32,40.6,19,20,3,17,13,41,29,1
393,408,394,Alex Oxlade-Chamberlain,Liverpool,3.7,5,4,1,2,2,1,5,20.0,4,5,2,3,1,6,4,0
394,409,395,David Ozoh,Crystal Palace,0.0,0,0,0,0,0,0,0,,0,0,0,0,0,0,0,0
395,410,396,João Palhinha,Fulham,34.5,147,83,58,65,24,71,134,53.0,63,48,5,43,46,193,61,2
396,411,397,Cole Palmer,Manchester City,4.1,5,1,0,3,2,3,5,60.0,2,2,1,1,1,6,2,0
397,412,398,Emerson Palmieri,West Ham,14.7,26,14,9,15,2,12,24,50.0,12,17,4,13,15,41,36,0
398,413,399,Lucas Paquetá,West Ham,23.9,71,53,23,36,12,27,66,40.9,39,41,4,37,16,87,31,0
399,414,400,Thomas Partey,Arsenal,27.6,70,40,20,35,15,25,52,48.1,27,26,5,21,28,98,41,1
400,416,401,Nathan Patterson,Everton,14.2,49,24,32,13,4,29,53,54.7,24,24,4,20,15,64,45,0
401,417,402,Ben Pearson,Bournemouth,3.2,7,3,3,3,1,1,3,33.3,2,4,0,4,2,9,6,0
402,418,403,Facundo Pellistri,Manchester Utd,0.7,1,1,0,1,0,0,0,,0,0,0,0,0,1,3,0
403,419,404,Andreas Pereira,Fulham,29.9,18,9,3,6,9,8,33,24.2,25,21,3,18,6,24,8,0
404,420,405,Ricardo Pereira,Leicester City,5.0,11,7,8,3,0,7,17,41.2,10,8,2,6,4,15,20,0
405,421,406,Ayoze Pérez,Leicester City,4.2,11,8,5,4,2,8,19,42.1,11,6,0,6,2,13,3,0
406,422,407,Ivan Perišić,Tottenham,23.4,42,24,25,10,7,27,47,57.4,20,29,7,22,22,64,49,1
407,423,408,Romain Perraud,Southampton,20.4,54,33,23,23,8,28,52,53.8,24,24,6,18,20,74,42,0
408,424,409,Máximo Perrone,Manchester City,0.2,0,0,0,0,0,0,0,,0,1,0,1,0,0,0,0
409,425,410,Cameron Peupion,Brighton,0.1,0,0,0,0,0,0,0,,0,0,0,0,0,0,0,0
410,426,411,Kalvin Phillips,Manchester City,3.3,6,4,3,3,0,2,9,22.2,7,7,3,4,5,11,10,0
411,427,412,Nathaniel Phillips,Liverpool,0.7,2,1,0,2,0,2,2,100.0,0,0,0,0,2,4,1,0
412,428,413,Jordan Pickford,Everton,37.0,0,0,0,0,0,0,1,0.0,1,0,0,0,4,4,15,3
413,429,414,Ethan Pinnock,Brentford,30.0,52,28,33,12,7,18,24,75.0,6,41,31,10,35,87,215,2
414,430,415,Daniel Podence,Wolves,19.7,27,17,13,9,5,6,31,19.4,25,19,0,19,7,34,6,0
415,431,416,Nick Pope,Newcastle Utd,36.2,1,0,1,0,0,1,3,33.3,2,0,0,0,0,1,27,2
416,432,417,Pedro Porro,Tottenham,12.6,25,16,8,15,2,14,39,35.9,25,25,2,23,15,40,24,1
417,433,418,Dennis Praet,Leicester City,7.2,12,9,5,6,1,6,11,54.5,5,12,2,10,5,17,6,0
418,434,419,Isaac Price,Everton,0.4,0,0,0,0,0,0,1,0.0,1,1,1,0,0,0,0,0
419,435,420,Christian Pulisic,Chelsea,9.1,11,6,3,6,2,3,5,60.0,2,8,1,7,4,15,4,0
420,436,421,Aaron Ramsdale,Arsenal,38.0,1,1,1,0,0,1,1,100.0,0,0,0,0,0,1,20,6
421,437,422,Jacob Ramsey,Aston Villa,29.3,69,39,23,35,11,32,69,46.4,37,48,8,40,23,92,34,0
422,438,423,Marcus Rashford,Manchester Utd,32.0,20,10,7,8,5,9,24,37.5,15,31,4,27,7,27,14,0
423,439,424,David Raya,Brentford,38.0,0,0,0,0,0,0,2,0.0,2,1,0,1,1,1,10,2
424,440,425,Tim Ream,Fulham,32.2,30,16,15,12,3,13,26,50.0,13,45,24,21,41,71,116,2
425,442,426,Nathan Redmond,Southampton,0.0,0,0,0,0,0,0,0,,0,0,0,0,0,0,0,0
426,443,427,Harrison Reed,Fulham,31.8,44,27,17,21,6,16,50,32.0,34,54,12,42,19,63,36,0
427,444,428,Bobby Reid,Fulham,27.5,42,24,14,14,14,16,34,47.1,18,25,3,22,20,62,28,1
428,445,429,Declan Rice,West Ham,36.4,79,38,44,31,4,31,50,62.0,19,45,15,30,63,142,58,0
429,446,430,Chris Richards,Crystal Palace,5.0,9,6,8,1,0,5,7,71.4,2,10,1,9,8,17,31,0
430,447,431,Richarlison,Tottenham,11.2,21,16,13,5,3,12,27,44.4,15,14,1,13,5,26,10,0
431,448,432,Jaïro Riedewald,Crystal Palace,0.7,2,1,2,0,0,0,1,0.0,1,2,0,2,0,2,4,0
432,449,433,Matt Ritchie,Newcastle Utd,0.4,1,1,0,1,0,1,3,33.3,2,0,0,0,1,2,0,0
433,450,434,Andrew Robertson,Liverpool,28.7,38,21,12,16,10,21,41,51.2,20,32,5,27,18,56,50,3
434,451,435,Antonee Robinson,Fulham,34.3,62,38,43,15,4,44,65,67.7,21,49,13,36,53,115,83,3
435,452,436,Joel Robles,Leeds United,4.0,0,0,0,0,0,0,1,0.0,1,0,0,0,0,0,2,1
436,453,437,Marc Roca,Leeds United,25.7,66,40,27,34,5,20,65,30.8,45,34,10,24,23,89,24,2
437,454,438,Marek Rodák,Fulham,2.0,0,0,0,0,0,0,0,,0,0,0,0,0,0,1,1
438,455,439,Rodri,Manchester City,32.3,67,41,28,28,11,26,52,50.0,26,40,14,26,33,100,43,1
439,456,440,Rodrigo,Leeds United,21.5,24,10,2,15,7,8,19,42.1,11,16,4,12,6,30,21,1
440,457,441,Mads Roerslev,Brentford,12.3,22,12,19,3,0,16,33,48.5,17,14,5,9,9,31,38,0
441,458,442,Cristian Romero,Tottenham,26.3,68,36,42,24,2,29,46,63.0,17,40,18,22,44,112,102,3
442,459,443,Oriol Romeu,Southampton,0.8,1,0,0,1,0,0,0,,0,1,0,1,1,2,1,0
443,460,444,Cristiano Ronaldo,Manchester Utd,5.8,2,2,1,0,1,1,2,50.0,1,0,0,0,1,3,9,0
444,461,445,Connor Ronan,Wolves,0.0,0,0,0,0,0,0,0,,0,0,0,0,0,0,0,0
445,462,446,Salomón Rondón,Everton,1.2,0,0,0,0,0,0,0,,0,1,1,0,0,0,0,0
446,463,447,Joe Rothwell,Bournemouth,11.3,20,13,7,12,1,7,21,33.3,14,14,3,11,9,29,7,0
447,464,448,Georginio Rutter,Leeds United,3.0,10,9,5,3,2,5,8,62.5,3,5,0,5,3,13,3,0
448,465,449,José Sá,Wolves,36.0,1,0,1,0,0,1,1,100.0,0,0,0,0,0,1,10,6
449,466,450,Marcel Sabitzer,Manchester Utd,7.0,12,8,3,8,1,2,11,18.2,9,6,2,4,8,20,11,0
450,468,451,Allan Saint-Maximin,Newcastle Utd,12.4,10,3,3,6,1,2,11,18.2,9,4,0,4,5,15,2,0
451,469,452,Bukayo Saka,Arsenal,35.3,63,34,22,15,26,20,44,45.5,24,38,0,38,14,77,19,0
452,470,453,Mohamed Salah,Liverpool,36.6,21,12,4,5,12,10,26,38.5,16,21,0,21,6,27,4,0
453,471,454,William Saliba,Arsenal,26.8,34,20,23,9,2,15,18,83.3,3,13,10,3,19,53,85,4
454,472,455,Mohammed Salisu,Southampton,21.9,51,29,33,16,2,24,34,70.6,10,56,25,31,31,82,122,1
455,473,456,Albert Sambi Lokonga,Arsenal,2.2,1,1,0,0,1,0,2,0.0,2,1,0,1,5,6,2,0
456,474,457,Albert Sambi Lokonga,Crystal Palace,6.0,13,10,7,4,2,8,12,66.7,4,8,3,5,7,20,10,0
457,475,458,Davinson Sánchez,Tottenham,9.5,24,11,17,6,1,14,20,70.0,6,16,10,6,12,36,41,0
458,476,459,Robert Sánchez,Brighton,23.0,1,0,1,0,0,0,0,,0,0,0,0,3,4,9,2
459,477,460,Jadon Sancho,Manchester Utd,18.7,16,10,7,5,4,8,28,28.6,20,25,2,23,7,23,6,0
460,478,461,Morgan Sanson,Aston Villa,0.1,2,1,1,1,0,1,1,100.0,0,0,0,0,0,2,0,0
461,479,462,Pablo Sarabia,Wolves,8.5,12,6,4,5,3,6,15,40.0,9,7,0,7,2,14,4,0
462,480,463,Jeremy Sarmiento,Brighton,2.0,6,3,4,1,1,2,5,40.0,3,2,0,2,1,7,0,0
463,481,464,Gianluca Scamacca,West Ham,10.3,10,5,1,3,6,2,2,100.0,0,3,0,3,4,14,5,0
464,482,465,Gustavo Scarpa,Nott'ham Forest,2.0,5,2,3,1,1,2,5,40.0,3,4,0,4,0,5,3,0
465,483,466,Kevin Schade,Brentford,8.1,12,8,7,2,3,5,10,50.0,5,7,0,7,4,16,6,0
466,484,467,Fabian Schär,Newcastle Utd,35.6,47,22,31,13,3,24,39,61.5,15,34,19,15,52,99,139,0
467,485,468,Jeffrey Schlupp,Crystal Palace,28.1,66,46,28,29,9,22,43,51.2,21,39,8,31,23,89,38,0
468,486,469,Nélson Semedo,Wolves,29.2,71,42,48,19,4,33,64,51.6,31,42,15,27,29,100,83,2
469,487,470,Antoine Semenyo,Bournemouth,2.9,1,0,0,0,1,1,6,16.7,5,10,1,9,2,3,4,0
470,488,471,Marcos Senesi,Bournemouth,27.7,50,35,28,22,0,23,43,53.5,20,38,20,18,43,93,146,2
471,489,472,Ryan Sessegnon,Tottenham,9.0,16,11,9,7,0,6,12,50.0,6,8,1,7,6,22,17,1
472,490,473,Luke Shaw,Manchester Utd,28.4,55,36,31,22,2,32,45,71.1,13,51,17,34,36,91,55,2
473,491,474,Jonjo Shelvey,Newcastle Utd,0.4,1,0,1,0,0,0,1,0.0,1,1,0,1,0,1,0,0
474,492,475,Jonjo Shelvey,Nott'ham Forest,6.0,2,1,0,1,1,1,9,11.1,8,7,2,5,5,7,10,1
475,494,476,Bernardo Silva,Manchester City,24.5,44,23,11,25,8,18,44,40.9,26,23,6,17,16,60,6,0
476,495,477,Thiago Silva,Chelsea,26.1,41,27,24,17,0,21,31,67.7,10,38,29,9,34,75,111,2
477,496,478,Ellis Simms,Everton,2.5,0,0,0,0,0,0,0,,0,0,0,0,0,0,1,0
478,497,479,Luis Sinisterra,Leeds United,9.6,21,14,8,9,4,11,18,61.1,7,11,1,10,8,29,2,0
479,498,480,Oliver Skipp,Tottenham,16.6,34,17,18,15,1,16,33,48.5,17,17,8,9,17,51,19,1
480,499,481,Adam Smith,Bournemouth,32.7,49,29,27,19,3,29,60,48.3,31,30,13,17,25,74,81,1
481,500,482,Emile Smith Rowe,Arsenal,1.9,1,1,1,0,0,1,3,33.3,2,1,0,1,0,1,2,0
482,501,483,Cédric Soares,Arsenal,0.3,0,0,0,0,0,0,1,0.0,1,1,0,1,0,0,1,0
483,502,484,Cédric Soares,Fulham,2.2,8,5,4,3,1,3,3,100.0,0,3,1,2,1,9,5,0
484,503,485,Dominic Solanke,Bournemouth,31.8,15,9,8,3,4,5,22,22.7,17,26,7,19,6,21,46,0
485,504,486,Manor Solomon,Fulham,6.4,20,12,12,6,2,9,16,56.3,7,8,0,8,5,25,3,0
486,505,487,Tomáš Souček,West Ham,31.3,77,37,41,29,7,28,58,48.3,30,42,17,25,53,130,71,3
487,506,488,Boubakary Soumaré,Leicester City,18.1,57,34,29,26,2,23,43,53.5,20,15,4,11,33,90,27,1
488,507,489,Harry Souttar,Leicester City,11.0,15,9,10,5,0,7,18,38.9,11,16,12,4,12,27,45,0
489,508,490,Çağlar Söyüncü,Leicester City,5.9,14,9,10,4,0,7,10,70.0,3,9,8,1,7,21,30,0
490,509,491,Djed Spence,Tottenham,0.1,0,0,0,0,0,0,0,,0,0,0,0,0,0,0,0
491,510,492,Jack Stacey,Bournemouth,3.3,5,4,3,1,1,2,5,40.0,3,3,1,2,5,10,15,0
492,511,493,Junior Stanislas,Bournemouth,0.7,0,0,0,0,0,0,0,,0,2,1,1,0,0,0,0
493,512,494,Jay Stansfield,Fulham,1.0,0,0,0,0,0,0,2,0.0,2,4,1,3,1,1,1,0
494,513,495,Jason Steele,Brighton,15.0,0,0,0,0,0,0,1,0.0,1,0,0,0,0,0,6,1
495,514,496,Jack Stephens,Southampton,0.5,2,2,2,0,0,1,1,100.0,0,1,1,0,1,3,2,0
496,515,497,Jack Stephens,Bournemouth,13.0,15,11,10,4,1,6,10,60.0,4,23,16,7,16,31,53,0
497,516,498,Raheem Sterling,Chelsea,21.0,18,10,5,4,9,8,14,57.1,6,17,0,17,2,20,5,0
498,517,499,John Stones,Manchester City,20.5,23,13,11,8,4,7,10,70.0,3,17,10,7,9,32,40,0
499,518,500,Pascal Struijk,Leeds United,24.4,84,57,43,31,10,49,75,65.3,26,32,12,20,32,116,70,1
500,520,501,Kamaldeen Sulemana,Southampton,10.7,15,9,4,7,4,4,14,28.6,10,16,0,16,6,21,6,0
501,521,502,Crysencio Summerville,Leeds United,15.8,30,20,14,14,2,11,23,47.8,12,20,2,18,13,43,11,0
502,522,503,Sam Surridge,Nott'ham Forest,3.6,5,0,1,3,1,1,4,25.0,3,5,2,3,0,5,7,0
503,523,504,Japhet Tanganga,Tottenham,1.6,3,2,3,0,0,1,5,20.0,4,1,0,1,2,5,8,0
504,524,505,Matt Targett,Newcastle Utd,6.8,13,10,8,3,2,9,24,37.5,15,8,3,5,9,22,16,0
505,525,506,James Tarkowski,Everton,38.0,51,26,36,13,2,20,38,52.6,18,99,78,21,51,102,201,3
506,526,507,Marcus Tavernier,Bournemouth,19.4,33,22,19,11,3,11,32,34.4,21,25,4,21,9,42,23,0
507,527,508,Tetê,Leicester City,8.2,14,8,5,7,2,6,21,28.6,15,9,0,9,2,16,3,0
508,528,509,Kenny Tete,Fulham,28.5,83,46,41,29,13,38,50,76.0,12,48,17,31,52,135,81,1
509,529,510,Luke Thomas,Leicester City,11.9,23,19,15,5,3,15,32,46.9,17,20,4,16,27,50,35,0
510,530,511,Youri Tielemans,Leicester City,26.0,66,39,27,30,9,23,61,37.7,38,35,8,27,28,94,24,1
511,531,512,Kieran Tierney,Arsenal,8.8,20,11,9,9,2,12,16,75.0,4,8,2,6,11,31,25,0
512,532,513,Harry Toffolo,Nott'ham Forest,10.4,17,8,10,4,3,10,14,71.4,4,16,8,8,10,27,33,0
513,533,514,Takehiro Tomiyasu,Arsenal,7.4,27,18,12,10,5,13,18,72.2,5,7,0,7,14,41,15,1
514,534,515,James Tomkins,Crystal Palace,3.8,4,2,2,1,1,1,3,33.3,2,3,2,1,5,9,19,0
515,535,516,Ivan Toney,Brentford,32.8,23,13,4,9,10,7,23,30.4,16,24,9,15,14,37,36,0
516,536,517,Adama Traoré,Wolves,16.6,14,7,7,4,3,4,9,44.4,5,8,1,7,3,17,17,0
517,537,518,Bertrand Traoré,Aston Villa,2.6,1,1,1,0,0,1,4,25.0,3,5,0,5,2,3,0,0
518,538,519,Boubacar Traoré,Wolves,4.6,12,5,4,5,3,3,7,42.9,4,4,2,2,7,19,1,0
519,539,520,Mark Travers,Bournemouth,11.5,0,0,0,0,0,0,0,,0,1,0,1,0,0,6,0
520,540,521,Kieran Trippier,Newcastle Utd,37.1,71,49,36,27,8,46,90,51.1,44,45,15,30,43,114,84,2
521,541,522,Leandro Trossard,Arsenal,10.3,12,7,4,2,6,6,18,33.3,12,18,0,18,6,18,3,1
522,542,523,Leandro Trossard,Brighton,14.6,10,6,7,1,2,1,8,12.5,7,17,0,17,6,16,1,0
523,543,524,Kostas Tsimikas,Liverpool,8.6,14,9,10,2,2,10,16,62.5,6,8,1,7,12,26,15,0
524,544,525,Deniz Undav,Brighton,7.0,7,4,2,2,3,2,8,25.0,6,4,1,3,0,7,1,0
525,546,526,Yan Valery,Southampton,0.5,0,0,0,0,0,0,0,,0,1,0,1,0,0,3,0
526,547,527,Virgil van Dijk,Liverpool,31.5,27,14,13,11,3,8,19,42.1,11,24,16,8,31,58,138,2
527,548,528,Raphaël Varane,Manchester Utd,21.2,24,9,18,6,0,7,17,41.2,10,24,17,7,11,35,91,0
528,549,529,Jamie Vardy,Leicester City,20.6,10,5,4,3,3,1,7,14.3,6,17,3,14,2,12,30,0
529,550,530,Joël Veltman,Brighton,24.3,62,32,44,14,4,37,57,64.9,20,27,8,19,19,81,51,0
530,551,531,Fabio Vieira,Arsenal,5.7,6,4,3,0,3,3,5,60.0,2,5,0,5,4,10,2,0
531,552,532,Matías Viña,Bournemouth,5.1,19,11,9,8,2,14,30,46.7,16,13,1,12,4,23,22,0
532,553,533,Rúben Vinagre,Everton,0.3,2,2,1,1,0,1,2,50.0,1,0,0,0,0,2,1,0
533,554,534,Carlos Vinícius,Fulham,12.3,4,1,0,2,2,0,4,0.0,4,7,0,7,0,4,10,0
534,555,535,Theo Walcott,Southampton,12.5,13,6,8,4,1,8,27,29.6,19,8,1,7,9,22,7,0
535,556,536,Kyle Walker,Manchester City,21.8,13,9,8,5,0,4,24,16.7,20,12,2,10,18,31,22,0
536,557,537,Kyle Walker-Peters,Southampton,29.4,61,32,34,24,3,22,42,52.4,20,47,8,39,27,88,52,0
537,558,538,Aaron Wan-Bissaka,Manchester Utd,15.9,40,25,20,17,3,23,25,92.0,2,24,8,16,22,62,41,0
538,559,539,Danny Ward,Leicester City,26.0,1,1,1,0,0,1,3,33.3,2,0,0,0,0,1,14,2
539,560,540,Joel Ward,Crystal Palace,25.1,50,36,30,11,9,30,41,73.2,11,32,16,16,25,75,80,1
540,561,541,James Ward-Prowse,Southampton,37.5,65,37,31,27,7,21,61,34.4,40,30,10,20,55,120,48,0
541,562,542,Ollie Watkins,Aston Villa,34.7,19,13,3,13,3,10,27,37.0,17,21,4,17,10,29,39,0
542,563,543,Adam Webster,Brighton,22.1,22,12,10,9,3,11,19,57.9,8,30,19,11,19,41,55,4
543,564,544,Wout Weghorst,Manchester Utd,8.9,11,5,6,1,4,2,9,22.2,7,7,2,5,7,18,9,0
544,565,545,Danny Welbeck,Brighton,20.6,15,7,0,7,8,4,11,36.4,7,24,2,22,5,20,20,0
545,566,546,Ben White,Arsenal,33.9,60,31,23,30,7,42,70,60.0,28,47,11,36,22,82,79,1
546,567,547,Harvey White,Tottenham,0.1,0,0,0,0,0,0,1,0.0,1,0,0,0,0,0,0,0
547,568,548,Joseph Whitworth,Crystal Palace,2.0,0,0,0,0,0,0,0,,0,0,0,0,0,0,1,0
548,569,549,Neco Williams,Nott'ham Forest,20.9,72,47,49,17,6,38,71,53.5,33,33,8,25,33,105,48,0
549,570,550,Willian,Fulham,23.6,13,8,8,3,2,7,25,28.0,18,13,0,13,9,22,9,0
550,572,551,Joe Willock,Newcastle Utd,28.4,51,30,13,26,12,25,58,43.1,33,54,8,46,25,76,17,0
551,573,552,Callum Wilson,Newcastle Utd,20.9,9,3,0,8,1,0,3,0.0,3,8,0,8,1,10,5,0
552,574,553,Harry Wilson,Fulham,12.2,21,13,9,9,3,8,18,44.4,10,17,2,15,6,27,14,0
553,575,554,Yoane Wissa,Brentford,17.8,17,12,4,7,6,6,13,46.2,7,10,0,10,6,23,15,0
554,576,555,Maximilian Wöber,Leeds United,14.1,25,18,9,15,1,16,24,66.7,8,32,14,18,27,52,67,1
555,577,556,Chris Wood,Newcastle Utd,5.0,5,4,0,3,2,3,5,60.0,2,2,2,0,1,6,7,0
556,578,557,Chris Wood,Nott'ham Forest,4.1,0,0,0,0,0,0,1,0.0,1,2,1,1,1,1,2,0
557,579,558,Joe Worrall,Nott'ham Forest,24.7,53,25,39,12,2,25,35,71.4,10,33,23,10,26,79,111,1
558,580,559,Granit Xhaka,Arsenal,33.3,34,27,11,18,5,16,41,39.0,25,28,10,18,15,49,45,1
559,581,560,Ryan Yates,Nott'ham Forest,20.4,38,19,19,16,3,14,22,63.6,8,26,8,18,10,48,44,0
560,582,561,Ashley Young,Aston Villa,22.6,50,27,34,15,1,37,49,75.5,12,25,11,14,21,71,65,0
561,583,562,Illia Zabarnyi,Bournemouth,3.3,4,2,4,0,0,3,7,42.9,4,7,2,5,3,7,14,0
562,584,563,Wilfried Zaha,Crystal Palace,25.4,32,20,12,12,8,8,21,38.1,13,21,1,20,16,48,9,0
563,585,564,Denis Zakaria,Chelsea,4.6,9,5,5,2,2,2,8,25.0,6,4,1,3,3,12,10,0
564,586,565,Jordan Zemura,Bournemouth,16.2,39,24,24,14,1,23,43,53.5,20,31,9,22,16,55,32,0
565,587,566,Oleksandr Zinchenko,Arsenal,23.5,40,18,14,17,9,21,39,53.8,18,20,2,18,22,62,38,2
566,588,567,Hakim Ziyech,Chelsea,7.3,20,12,12,5,3,4,9,44.4,5,8,0,8,5,25,5,1
567,589,568,Kurt Zouma,West Ham,22.1,9,4,4,5,0,5,8,62.5,3,17,14,3,30,39,120,1
568,590,569,Martin Ødegaard,Arsenal,34.7,36,23,12,14,10,14,47,29.8,33,20,5,15,6,42,12,1
